1111111111111111111111111111111111
1E0000000000000C00000C000000000011
10100101001000001010010000M0010101
1010010M10101010001001000000010101
100000000C00C000M00000000P000000C1
1111111111111111111111111111111111