1111111111111111111111111111111111
1E0000000000000C00000C000M00000011
1010010100100000101001000000010101
1010010010101010M0100100000001M101
100000000C00C000000000000P000000C1
1111111111111111111111111111111111