1111111111111111111111111111
1E0000000C00000C000000000011
1000000000101000000001000000001
1000001000001001000000000001
100C00C000000000000P000000C1
1111111111111111111111111111