1111101111
1P00C00101
1000111101
1110111101
1000100C01
1011101111
100C001011
1001100001
11100CE011
1111111111