1111111111111111111111111111111111
1E0000000000000C00000C000000011011
10100100001000001010010000M0011101
1010010010101010001001000000011101
100000000C00C000M00000000P000110C1
1111111111111111111111111111111111