1111111111111111111111111111111111
1E00000M0000000C00000C000000000011
1010010M001000001010010000M0010101
1010010M10101010001001000000010101
1000000M0C00C000M00000000P000000C1
1111111111111111111111111111111111