1111111111
1P00C00101
1000100101
1010110101
1000100C01
1000101111
100C001011
1001100001
11100CE011
1111111111