111111111111111
1P0000000000001
1000000C0000001
111111111100001
100000000000001
10M000000000001
100000000111001
1000C0000001001
100000M00C01001
100000000001001
1000C0000001001
100000000111001
100M00000000001
100000000C000E1
111111111111111