11111111111111111111111111111111111
1P000000000000000000000000000000001
10000000000000000000000000000000001
10000000000000000000000000000000001
10000CC0000000000C0000000000CC00001
10000C00000000000000000000000C00001
10000000000001111111110000000000001
10000000000001111111110000000000001
10000000000001111111110000000000001
10000C00000001111111110000000C00001
10000000000001111111110000000000001
10000000000001111111110000000000001
10000000000001111111110000000000001
10000C00000000000000000000000C00001
10000CC0000000000C0000000000CC00001
10000000000000000000000000000000001
10000000000000000E00000000000000001
10000000000000000000000000000000001
10000000000000000000000000000000001
11111111111111111111111111111111111