111111111111111111111111111111111111111
1P0000000000000000000000000000000000001
100000000000000000000000000000000000001
100000000000000000000000000000000000001
10000CC00000M0000C00000M0000CC000000001
10000C00000000000000000000000C000000001
100000000000000000000000000000000000001
100000M0000000000000000000000M000000001
100000000000000000000000000000000000001
10000C00000000000100000000000C000000001
100000000000000000000000000000000000001
10000M00000000000000000000000M000000001
100000000000000000000000000000000000001
10000C00000000000000000000000C000000001
10000CC00000M0000C000000M000CC000000001
100000000000000000000000000000000000001
10000000000010000E000000100000000000001
100000000000000000000000000000000000001
100000000000000000000000000000000000001
100000000000000000000000000000000000001
111111111111111111111111111111111111111